|                 |
|                 |
|                 |
|                 |
|                 |
|                 |
|                 |
|                 |
|                 |
|                 |
|                 |
|                 |
|                 |
|                 |
|                 |
|                 |
|=================|
|                 |
|                 |
|                 |
|                 |
|                 |
|                 |
|                 |
|                 |
|                 |
|                 |
|                 |
|                 |
}----             |
|   |             |
|   |             |
|   |             |
|   |             |
|   ------        |
|       x         |
|                 |
|                 |
|                 |
|                 |
|                 |
|               x |
|                 |
|                 |
|                 |
|                 |
|                 |
|x                |
|                 |
|                 |
|                 |
|                 |
|                 |
|                 |
|                 |
|                 |
|                 |
|                 |
|   ------        |
|                 |
|                 |
|           <-----{
|                 |
|                 |
|   x      x      |
|                 |
| x     x     x   |
|                 |
|                 |
|                 |
|                 |
|                 |
|                 |
|                 |
|                 |
|                 |
|                 |
|                 |
}-------->  x <-> |
|@                |
|                 |
|                 |
|        ^        |
|        |        |
|        |        |
|        L--------{
|@               @|
|                 |
|                 |
|                 |
|          <------{
|                 |
|                 |
|               x |
|                 |
}---->          x |
|                 |
|                 |
|                 |
|                 |
|                 |
|                 |
