|                 |
|                 |
|                 |
|                 |
|                 |
|                 |
|                 |
|                 |
|                 |
|                 |
|                 |
|                 |
|=================|
|                 |
|                 |
|                 |
|=================|
|                 |
|                 |
|                 |
|                 |
|                 |
|                 |
|                 |
|                 |
|                 |
|                 |
|                 |
|                 |
}---7             |
|   |             |
|   |             |
|   |             |
|   |             |
|   L-----        |
|       x         |
|                 |
|                 |
|                 |
|                 |
|                 |
|               x |
|                 |
|                 |
|                 |
|                 |
|                 |
|x                |
|                 |
|                 |
|                 |
|                 |
|                 |
|                 |
|                 |
|                 |
|                 |
|                 |
|   <---->        |
|                 |
|                 |
|           <-----{
|                 |
|                 |
|                 |
|                 |
|                 |
|                 |
|                 |
|                 |
|                 |
|                 |
|                 |
|                 |
|                 |
|                 |
|                 |
|                 |
}-------->    <-> |
|                 |
|                 |
|                 |
|        ^        |
|        |        |
|        |        |
|        L--------{
|@               @|
|                 |
|                 |
|                 |
|          <------{
|                 |
|                 |
|               x |
|                 |
}---->          x |
|                 |
|                 |
|                 |
|                 |
|                 |
|                 |
